6 1
3
12 3
12 4
1 6
1 1 1 1 1 1 1 1
1 0 0 1 0 0 5 1
1 0 0 1 0 0 0 1
1 0 0 0 0 0 0 1
1 0 0 0 0 0 0 1
1 0 0 0 0 3 0 1
1 0 0 0 0 0 0 1
1 0 0 0 0 0 0 1
1 0 0 0 0 0 0 1
1 1 1 1 0 0 0 1
1 0 0 2 0 0 0 1
1 0 0 3 0 0 0 1
1 0 0 4 5 1 1 1
1 1 1 1 1 1 1 1

1 1 1 1 1 1 1 1
1 0 0 1 0 0 4 1
1 0 0 1 3 0 0 1
1 0 0 0 0 0 0 1
1 0 0 0 0 0 0 1
1 0 0 0 0 3 0 1
1 2 0 0 0 0 0 1
1 0 0 0 0 0 0 1
1 0 3 0 0 0 0 1
1 1 1 1 0 0 0 1
1 0 0 0 0 0 0 1
1 0 0 0 0 0 0 1
1 0 0 4 4 1 1 1
1 1 1 1 1 1 1 1