1 1
3
2 1
1 6
12 6
1 1 1 1 1 1 1 1
1 2 0 0 0 0 4 1
1 4 0 0 0 0 0 1
1 0 0 0 0 0 0 1
1 0 1 1 0 1 1 1
1 0 0 0 0 0 0 1
1 0 0 1 0 3 0 1
1 0 0 1 1 1 0 1
1 0 3 0 0 0 0 1
1 0 0 0 0 0 0 1
1 0 0 1 1 1 0 1
1 3 0 1 1 1 0 1
1 0 0 1 1 1 4 1
1 1 1 1 1 1 1 1