1 1
5
1 3
5 1
10 2
3 6
12 6
1 1 1 1 1 1 1 1
1 2 1 4 0 3 0 1
1 0 1 3 0 1 0 1
1 0 0 0 0 0 4 1
1 1 1 3 1 3 0 1
1 4 1 0 1 0 0 1
1 0 1 0 1 0 0 1
1 0 0 0 0 1 1 1
1 0 0 0 0 3 0 1
1 0 1 0 0 0 0 1
1 0 4 1 1 0 1 1
1 0 0 0 0 0 0 1
1 0 0 1 0 0 4 1
1 1 1 1 1 1 1 1