6 4
5
1 1
1 6
12 1
12 6
6 3
1 1 1 1 1 1 1 1
1 4 0 0 0 0 4 1
1 0 0 1 0 0 0 1
1 0 0 0 1 0 0 1
1 0 0 0 3 0 0 1
1 1 0 3 0 0 0 1
1 1 1 4 2 3 0 1
1 1 0 3 0 0 0 1
1 0 0 0 3 0 0 1
1 0 0 0 1 0 0 1
1 0 0 1 1 0 0 1
1 0 0 1 0 0 0 1
1 4 0 0 0 0 4 1
1 1 1 1 1 1 1 1