3 5
4
1 4
1 5
1 6
11 1
1 1 1 1 1 1 1 1
1 0 0 0 4 4 4 1
1 0 0 1 3 3 1 1
1 0 1 0 3 2 0 1
1 0 1 0 0 0 0 1
1 0 1 0 1 0 1 1
1 0 1 0 1 0 0 1
1 0 1 0 1 1 0 1
1 0 0 0 0 1 0 1
1 0 1 0 0 0 0 1
1 0 0 0 1 0 1 1
1 4 0 0 1 3 0 1
1 0 0 0 0 0 0 1
1 1 1 1 1 1 1 1