4 3
8
1 1
1 6
2 2
6 3
8 1
10 1
12 1
11 4
1 1 1 1 1 1 1 1
1 4 0 1 0 1 4 1
1 0 4 1 0 1 0 1
1 0 0 1 0 3 0 1
1 0 3 2 0 0 0 1
1 0 0 3 1 0 0 1
1 0 1 4 0 3 0 1
1 1 1 1 0 1 0 1
1 4 0 0 0 1 0 1
1 0 0 3 0 0 0 1
1 4 3 0 3 0 0 1
1 1 0 1 4 1 1 1
1 4 0 3 0 0 0 1
1 1 1 1 1 1 1 1