1 1
4
6 3
6 4
7 3
7 4
1 1 1 1 1 1 1 1
1 2 1 1 1 0 0 1
1 0 0 1 1 3 0 1
1 0 0 0 0 0 0 1
1 0 0 0 1 1 0 1
1 0 0 0 0 0 0 1
1 0 0 4 4 0 0 1
1 1 1 4 4 1 0 1
1 0 3 0 0 1 0 1
1 0 0 0 0 1 0 1
1 0 1 1 0 3 0 1
1 0 3 0 0 1 0 1
1 0 0 1 0 0 0 1
1 1 1 1 1 1 1 1