1 3
6
1 1
11 1
4 2
4 4
4 6
12 6
1 1 1 1 1 1 1 1
1 4 0 2 0 1 1 1
1 1 3 1 3 0 0 1
1 1 0 1 0 1 0 1
1 1 4 0 4 3 4 1
1 1 0 1 1 0 0 1
1 1 0 0 0 3 1 1
1 0 0 0 0 0 0 1
1 0 3 0 1 0 0 1
1 0 1 0 1 0 0 1
1 0 1 0 3 0 1 1
1 4 1 1 1 0 0 1
1 0 0 0 0 0 4 1
1 1 1 1 1 1 1 1