4 4
16
1 2
1 4
2 3
5 1
5 2
6 3
6 6
7 1
7 3
7 4
8 2
9 5
9 3
10 5
11 4
12 6
1 1 1 1 1 1 1 1
1 0 4 0 4 0 0 1
1 3 0 4 0 0 3 1
1 0 3 3 3 3 0 1
1 0 0 3 2 3 0 1
1 4 4 3 3 3 0 1
1 0 0 4 0 0 4 1
1 4 3 4 4 0 0 1
1 0 4 0 3 0 0 1
1 0 0 4 3 4 0 1
1 0 3 0 1 4 0 1
1 0 1 1 4 0 0 1
1 0 0 3 0 0 4 1
1 1 1 1 1 1 1 1